S . . # . . .
. # . # . # .
. # . . . # .
. . # # . . .
. . . . # . G
